1:5
2:3
3:4
4:7
--
1, 2 / 5
1, 4 / 2
2, 3 / 2
2, 4 / 6
3, 4 / 3
4, 1 / 3